##############
#s...........#
######..######
#............#
#............#
#####........#
#...#........#
#.k......##..#
#...#..###...#
#####....e...#
##############