#######################
#ks...................#
#....#########........#
#.....##..............#
#......##......########
##########............#
####.k......######..###
#......#.......###....#
#......#.......###..e.#
#######################