############
#.......e..#
#...##...k.#
#s.....##..#
############