#######################
#.s...................#
#....#########........#
#.....##.....k........#
#......##.......#######
#.......##............#
####...........###....#
#..............###....#
#............e.###....#
#######################