############
#.......e..#
#...##.....#
#s.....##..#
############