#######################
#.s...................#
#....#########........#
#.....##..............#
#......##.......#######
#.......##............#
####...........###....#
#..............###....#
#............e.###....#
#######################